111111111111111111111111111111111111111111111111111111111111
111111111111111111111111111111111111111111111111111111111111
111111111111111111111111111111111111111112222111222221111111
111111111111111111111111111111111111111222002222200022111111
111111111111111111111111111111111111112200000000000002211111
111111111111111111111111111111111111112000000000000000211111
111111111111111111111111111111111111112000000000000000221111
111111111111111111111111111111111111112200000000000000021111
111111111111122111111111122111111111111222000000000000221111
111111111111122111111111122111111222111112000000000222211111
111111111122222222222222222222222222222222221102222211111111
111111111121111111111111112211111111111001122222111111111111
111111111121111111111111112211111111100000021111111111111111
111111111121111111111111112211111110000001121111111111111111
111111111121111111111111112211111100000011121111111111111111
111111111121111111111111112211111000000001122222222222222222
111111111121111111111111112211111100000001121111111111111111
111111111121111111111111112211111110000111121111111111111111
111111111121111122111111112211111111111111121111111111111111
111111111121111122111111112211111111111111121111111111111111
111111111122222222222222222222222222222222221111111111111111
111111111111111111111111112211111111112111111111111111111111
111111111111111111111111112211111111112111111111111111111111
111111111111111111111111112211111111112111111111111111111111
111111111111111111111111112211111111112111111111111111111111
111111111111111111111111112211111111112111111111111111111111
111111111111111111111111112211111111112111111111111111111111
111111111111111111111111112211122111112111111111111111111111
111111111111222111112221112211122111112111121111111111111111
111111222222222222222222222222222222222222221111111111111111
111111111111111111111111111111111111111111111111111111111111
111111111111111111111111111111111111111111111111111111111111
111111111111111111111111111111111111111111111111111111111111
111111111111111111111111111111111111111111111111111111111111
