0:736:512:16:23:1:1
1:928:480:15:29:1:1
2:1280:544:17:40:1:1
3:384:320:12:10:1:1
0:672:384:12:21:1:1
1:1280:256:8:40:1:1
2:1024:896:28:32:1:1
3:320:544:17:10:1:1